25 25
O O O V V V V V V V O O O V V V V V V V V V V V V
G V O O O V V V V V O V O O O V V V V V V V V V V
V V V O V V V O V V V V V O V V V O V V V V O V V
V V V V V V V O V V V V V V V V V O V V V V O V V
V V V V V V V O V V V V V V V V V O V V V V O V V
V V V O O O V V V V V V V O O O V V V V O V V V V
V V V V V O V V V V V V V V V O V V V V O V V V V
V V V V V O V V V V V V V V V O V V V V O V V V V
V O O V V V V V V V V O O V V V V V V V V V V V V
V O V V V V V V V V V O V V V V V V V V V V V V V
O O O V V V V V V V O O O V V V V V V V V V V V V
V V O O O V V V V V V V O O O V V V V V V V V V V
V V V O V V V O V V V V V O V V V O V V V V O V V
V V V V V V V O V V V V V V V V V O V V V V O V V
V V V V V V V O V V V V V V V V V O V V V V O V V
V V V O O O V V V V V V V O O O V V V V O V V V V
V V V V V O V V V V V V V V V O V V V V O V V V V
V V V V V O V V V V V V V V V O V V V V O V V V V
V O O V V V V V V V V O O V V V V V V V V V V V V
V O V V V V V V V V V O V V V V V V V V V V V V V
V V V O O O V V V V V V V O O O V V V V O V V V V
V V V V V O V V V V V V V V V O V V V V O V V V V
V V V V V O V V V V V V V V V O V V V V O V V V V
V O O V V V V V V V V O O V V V V V V V V V V V V
V O V V V V V V V V V O V V V V V V V V V V V V V